00000000000000000000
00111111100000000000
00100000100001111110
00111111111111000010
00100000000001000020
00120000000001000000
00100000111111111000
00100000100000101100
00111120100000100110
00001000100211100020
00001020100000000000
01111010111111111130
01000010010000010000
01001111110112010000
01001000000100011100
02001000011102000100
00001000010001000100
02111000010001000100
00001111111111111100
00000000000000000000