00000000000000000000
01111111021111111100
01010001000000000100
01020201000111110110
01000101000100010010
01110101111102111110
00010101000000000000
00111101011111111120
00100001001000000000
00111111111011111110
00000001000010000010
02111111111110011110
00010000000010010010
00010001110211111000
00111001010010001200
00101111010111000000
00100000010101021110
00111100010100000010
00100200030111111110
00000000000000000000