00000000000000000000
00111000111200000200
01101000100000111110
01001111100000200010
02001000000000000010
00001000000111111110
00001111111100000010
00001000000100000010
00001000000100000010
00001000001111100010
00111111201000100020
00100000001130100000
00100000000000111110
00111111111111100000
00000000010000000200
00211000010000000100
00001002011111111110
00001001010000000010
00001111110000000020
00000000000000000000