00000000000000000000
03111111111111111110
01000000000000000010
01001111111111120010
01001000010000000010
01111000011111111110
00101000000000000000
00101111111111112020
00100000010000010010
02111111110000011110
00000000000000010000
00011110020000010120
00010011111111110100
00010000100000000100
00010020100000000100
00011110102111111100
00000000100000000100
00211111111111111100
00000000000000020000
00000000000000000000